1 1 1 1 1 1 1 1 1 1 1 1 1 
1 0 0 0 1 7 17 7 1 0 0 0 1 
1 0 1 0 1 7 7 7 1 0 1 0 1 
1 0 1 0 1 1 9 1 1 0 1 0 1 
1 0 1 0 1 8 8 8 1 0 1 0 1 
1 0 1 0 1 8 0 8 1 0 1 0 1 
1 0 1 0 1 1 9 1 1 0 1 0 1 
1 0 1 0 1 0 0 0 1 0 1 0 1 
1 0 1 0 1 0 0 0 1 0 1 0 1 
1 0 1 0 1 1 0 1 1 0 1 0 1 
1 0 1 0 1 0 0 0 1 0 1 0 1 
1 13 1 0 0 0 0 0 0 0 1 0 1 
1 1 1 1 1 1 1 1 1 1 1 1 1 
