1 1 1 1 1 1 1 1 1 1 1 1 1 
1 0 0 0 0 0 1 10 0 0 0 0 1 
1 1 1 0 1 1 1 1 1 0 0 0 1 
1 0 0 0 0 0 0 0 1 0 0 0 1 
1 0 1 1 0 1 1 0 1 14 0 14 1 
1 0 1 0 0 0 1 0 1 7 0 7 1 
1 0 1 1 1 1 1 0 1 1 0 1 1 
1 0 0 0 0 0 0 0 0 0 0 0 1 
1 1 1 9 1 1 0 1 1 1 1 0 1 
1 2 6 14 3 1 0 1 0 0 0 0 1 
1 2 7 7 3 1 0 1 14 0 0 0 1 
1 4 7 7 3 1 0 1 0 0 0 0 1 
1 1 1 1 1 1 0 1 1 1 1 1 1 
