1 1 1 1 1 1 1 1 1 1 1 1 1 
1 4 14 0 0 3 1 10 5 0 0 3 1 
1 1 1 0 1 1 1 1 1 0 0 0 1 
1 0 0 0 0 0 0 0 1 0 0 0 1 
1 0 1 1 0 1 1 0 1 0 0 0 1 
1 0 1 0 0 0 1 0 1 0 0 7 1 
1 0 1 1 1 1 1 0 1 1 0 1 1 
1 0 0 0 0 0 0 0 0 0 0 0 1 
1 1 1 0 1 1 0 1 1 1 1 0 1 
1 0 0 0 3 1 0 1 0 0 0 0 1 
1 0 0 0 3 1 0 1 0 0 0 0 1 
1 0 0 0 3 1 0 1 0 0 0 0 1 
1 1 1 1 1 1 0 1 1 1 1 1 1 
