1 1 1 1 1 1 1 1 1 1 1 1 1 
1 0 0 0 0 0 1 10 5 0 0 0 1 
1 1 1 0 1 1 1 1 1 0 0 0 1 
1 0 0 0 0 0 0 0 1 0 0 0 1 
1 0 1 1 9 1 1 0 1 14 0 14 1 
1 0 1 4 7 7 1 0 1 0 0 0 1 
1 0 1 1 1 1 1 0 1 1 0 1 1 
1 0 0 0 0 0 0 0 0 0 0 0 1 
1 1 1 0 1 1 0 1 1 1 1 0 1 
1 0 0 0 0 1 0 1 0 0 0 0 1 
1 0 0 0 0 1 0 1 0 0 0 0 1 
1 0 0 0 0 1 0 1 0 0 0 0 1 
1 1 1 1 1 1 0 1 1 1 1 1 1 
