1 1 1 1 1 1 1 1 1 1 1 1 1 
1 15 0 0 1 7 17 7 1 0 0 15 1 
1 0 1 2 1 7 7 7 1 3 1 0 1 
1 0 1 2 1 1 9 1 1 3 1 0 1 
1 0 1 2 1 8 8 8 1 3 1 0 1 
1 0 1 2 1 8 0 8 1 3 1 0 1 
1 7 1 4 1 1 9 1 1 7 1 0 1 
1 0 1 3 1 7 6 7 1 2 1 0 1 
1 0 1 3 1 7 7 7 1 2 1 0 1 
1 0 1 3 1 1 14 1 1 2 1 0 1 
1 0 1 3 1 0 0 0 1 2 1 0 1 
1 13 1 0 0 0 0 0 0 0 1 4 1 
1 1 1 1 1 1 1 1 1 1 1 1 1 
