1 1 1 1 1 1 1 1 1 1 1 1 1 
1 0 0 0 1 0 1 11 0 0 0 0 1 
1 0 0 0 0 0 1 1 1 1 1 0 1 
1 0 0 0 1 0 1 0 0 0 1 0 1 
1 0 0 0 1 0 1 0 1 0 1 0 1 
1 1 0 1 1 0 1 0 1 0 1 0 1 
1 0 0 0 1 0 1 0 0 0 0 0 1 
1 0 0 0 1 0 1 0 1 1 1 1 1 
1 0 0 0 1 0 1 0 1 0 0 0 1 
1 1 16 1 1 0 1 0 1 0 0 0 1 
1 0 0 0 1 0 1 0 1 0 0 0 1 
1 12 6 7 1 0 0 0 0 0 0 0 1 
1 1 1 1 1 1 1 1 1 1 1 1 1 
