1 1 1 1 1 1 1 1 1 1 1 1 1 
1 2 0 3 1 4 1 11 0 0 0 14 1 
1 0 14 0 9 14 1 1 1 1 1 0 1 
1 0 14 0 1 0 1 0 0 2 1 0 1 
1 3 0 2 1 0 1 0 1 0 1 0 1 
1 1 9 1 1 0 1 0 1 0 1 0 1 
1 7 15 7 1 0 1 0 2 0 0 15 1 
1 7 0 7 1 0 1 0 1 1 1 1 1 
1 14 14 14 1 0 1 0 1 4 8 6 1 
1 1 16 1 1 0 1 0 1 2 3 2 1 
1 0 0 0 1 0 1 0 1 3 2 3 1 
1 12 6 7 1 0 0 0 9 7 4 7 1 
1 1 1 1 1 1 1 1 1 1 1 1 1 
